u	lu
tu	itu
gakmaw	enggak mau
bbg	babang
btw	by the way
wa	gua
brt	berarti
bcs	because
pa	apa
nga	enggak
kulyeah	kuliah
brrouw	bro
pls	please
mjd	menjadi
broou	bro
gabs	enggak boleh
ay	aku
gamawo	enggak mau
tjd	terjadi
tbtb	tiba-tiba
mn	mana
janlup	jangan lupa
v	tapi
masy	masyarakat
govt	pemerintah
kzl	kesal
jjs	jalan-jalan sore
gblk	goblok
u	you
kalean	kalian
klean	kalian
twtr	twitter
brow	bro
jtg	jawa tengah
tetibs	tiba-tiba
jateng	jawa tengah
jabar	jawa barat
gjd	enggak jadi
smd	samarinda
minom	minum
mdn	medan
msyrkt	masyarakat
bg	bagi
mhs	mahasiswa
mhsw	mahasiswa
gamao	enggak mau
pars	parah
positive	positif
negative	negatif
mantab	mantap
mangstab	mantap
gt	gitu
niy	ini
iniih	ini
skolh	sekolah
aplgi	apalagi
klau	kalau
srh	suruh
kaleee	kali
padal	padahal
melaks	melaksanakan
hatus	harus
masik	masih
sbnre	sebenarnya
aselik	asli
tergabing	tergabung
menerpakan	menerapkan
tida	tidak
gamuk	enggak mau
mlkukan	melakukan
baguuuuus	bagus
sampe	sampai
ngikutin	mengikuti
gayany	gayanya
ngikutin	mengikuti
lg	lagi
bnk	bang
awaas	awas
siip	sip
abizzzz	habis
kerrrrennnn	keren
sayaa	saya
pengen	pengin
kpan	kapan
bgt	banget
sma	sama
sdkit	sedikit
bngt	banget
lgu	lagu
bener2	benar-benar
kharismanya	karismanya
aq	aku
yg	yang
jdi	jadi
lgi	lagi
gk	enggak
kek	kayak
lgunya	lagunya
kpan	kapan
kereeeeennnn	keren